生成10行5列的迷宫为:
1 1 1 1 1 1 1 
1 0 0 0 0 0 1 
1 0 1 0 0 1 1 
1 0 0 1 0 0 1 
1 0 0 1 1 0 1 
1 0 0 1 1 1 1 
1 0 1 0 1 1 1 
1 1 0 0 0 1 1 
1 0 0 1 0 0 1 
1 1 1 1 0 0 1 
1 1 0 0 0 0 1 
1 1 1 1 1 1 1 
没有通路!
